
  ##          # #              #    #   #
  # #  #  ## ## ##   #    #   #     ## ##  #  # #  #
  # # ### # # # # # #    # # ###    # # # # # ##  #
  # # #   # # # # #  #   # #  #     #   # # # #    #
  ##   ## ##  # # # #     #   #     #   #  ## #   #
          #


#######################################################
#######################################################
#######################################################
#######################################################
