##          # #     
# #  #  ## ## ##   #
# # ### # # # # # # 
# # #   # # # # #  #
##   ## ##  # # # # 
        #p
############# ######
#####   #### #######
####     ##   ######
#####   #### #######
####################
#  #  ## ##  ###  ##
# # # # # # # #  ###
# ### #   #  ####  #
# ### # # # # #   ##
####################

         #
         #
         #
       # # #
        ###
         #


