##          # #     
# #  #  ## ## ##   #
# # ### # # # # # # 
# # #   # # # # #  #
##   ## ##  # # # # 
        #
############# ######
#####   #### #######
####   p ##   ######
#####   #### #######
####################
#  #  ## ##  ###  ##
# # # # # # # #  ###
# ### #   #  ####  #
# ### # # # # #   ##
####################
