#######     ########
######   p   #######
#####         ######
######       #######
#######     ########
########   #########
########   #########
########   #########
####       #########
####       #########
####   #############
# #     # # # # # ##
####   #############
####   #############
####               #
####               #
####               #
######             #
########           #
##########         #
############     ###
##############   ###
##############   ###
##############   ###
#############    ###
#####    ###    ####
###            #####
##            ######
##    ##     #######
##   ###############
##   ###############
##   ###############
##    ##############
##    ##############
###              ###
###              ###
###              ###
###              ###
##########       ###
###########      ###
###              ###
###              ###
###     ############
###    #############
###        #########
###           ######
######        ######
#######      #######
########    ########
#######      #######
######        ######
######        ######
#######      #######
########oOOo########
#########OO#########
####################
