########    ########
#######      #######
######        ######
#######      #######
########    ########
#########  #########
#########  #########
#########  #########
####       #########
####       #########
####  ##############
# #   # # # # # # ##
####  ##############
####  ##############
####               #
####               #
######             #
########           #
##########         #
############       #
##############   ###
##############   ###
##############   ###
##############   ###
#############   ####
#############   ####
####      ##   #####
###           ######
###   ##     #######
###  ###############
###  ###############
###  ###############
###  ###############
###  ###############
###              ###
###              ###
###              ###
###              ###
##########       ###
###########      ###
###              ###
###              ###
###     ############
###    #############
###        #########
###           ######
######        ######
#######      #######
########    ########
#######      #######
######        ######
######        ######
#######      #######
########oOOo########
#########OO#########
####################

